25 20
#############
#...........#    ########
#...s...s...######......#
#.......................#
#...........######......#
#.....s.....#    #......#
#...........#    #...k..#
#a..........#    #......#
#####..######    ###..###
    #..#           #..#
    #..#           #..#
    #..#          ##..##
  ###..####      #......#
  #..@....#      #......#
  #...w...#      #......#
  #.......#      #......#
  #.......#      #......#
  #.......#      #......#
  #.......#      #......#
  #########       ######
