25 20

#########################
#......ppp..sssss.......#
#.............stt.......#
#h.......s........sssg..#
#...........######..k.b.#
#......s....#    #....pp#
#r..........#    #....pp#
#Rf.........#    #....pp#
#####..######    ########
    #..#
    #..#
    #s.#
###....##################
#..........R........s...#
#.....w....R....s########
#..........R...sgD......#
#....@.....b....s#....f.#
#..........R.....#......#
#..ppp.....R.....#......#
#########################
